ÉÍÍÍÍÍÍÍÍÍÍÍÍÍ»"""""""""""""""""""~~~""""""""""""ÉÍÍÍÍÍÍÍÍÍÍÍÍÍÍ»
º             º""""""""""""""""""O~~~""""""""""""º              º
º             º"""""""""""""""""""~~~""""""""""""º              º
º             º""""""""""""""""""~~~"""O"""""""""º              º
º             º"""""""O"""""""""ÀÄÄÄÙ""""""""""""º              º
º             º"""""""""""""""""=====""""""""""""º              º
º      t      +"""""""""""""""""ÚÄÄÄ¿""""""""""""+        0     º
º             º""""""""""""""""""~~~"""""""""""""º              º
º            º"""""""O"""""""""~~~""""""""""""""º              º
º             º"""""""""""""""""~~~""""""""O"""""º              º
º             º""""""""""""""""""~~~"""""""""""""º              º
º             º""""""""""""""O"""~~~"""""""""""""º              º
ÈÍÍÍÍÍÍÍÍÍÍÍÍÍ¼"""""""""""""""""""~~~""""""""""""ÈÍÍÍÍÍÍÍÍÍÍÍÍÍÍ¼