ÉÍÍÍÍÍÍÍÍÍÍÍÍÍ»HHHHHHHHHHHHHHHHHHHHHHHHHHHHHHHHHHHHHÉÍÍÍÍÍÍÍÍÍÍÍÍÍÍ»
º.............º..................O..................º..............º
º.............º.....................................º..............º
º.............º........................O............º..............º
º.............º.......O.............................º..............º
º.............º..............g......................º..............º
º..U...t......+.....................................+.......0......º
º.............º.....................................º..............º
º.>...........º.......O.............................º..............º
º.............º............................O........º..............º
º.............º.....................................º..............º
º.............º..............O......................º..............º
ÈÍÍÍÍÍÍÍÍÍÍÍÍÍ¼HHHHHHHHHHHHHHHHHHHHHHHHHHHHHHHHHHHHHÈÍÍÍÍÍÍÍÍÍÍÍÍÍÍ¼