╔═════════════╗HHHHHHHHHHHHHHHHHHHHHHHHHHHHHHHHHHHHH╔══════════════╗
║.............║..................O..................║..............║
║.............║.....................................║..............║
║.............║........................O............║..............║
║.............║.......O.............................║..............║
║.............║..............g......................║..............║
║..U...t......+.....................................+.......0......║
║.............║.....................................║..............║
║.>...........║.......O.............................║..............║
║.............║............................O........║..............║
║.............║.....................................║..............║
║.............║..............O......................║..............║
╚═════════════╝HHHHHHHHHHHHHHHHHHHHHHHHHHHHHHHHHHHHH╚══════════════╝